24 19 19 19 19 19 19 19 19 19 19 19 19 19 19 19 19 19 19 23
14 1 1 1 1 1 1 1 1 1 1 1 1 1 1 1 1 1 1 13
14 1 1 1 1 1 1 1 1 1 1 1 1 1 1 1 1 1 1 13
14 1 1 1 1 1 1 1 1 1 1 1 1 1 1 1 1 1 1 13
14 1 1 1 1 1 1 1 1 1 1 1 1 1 1 1 1 1 1 13
14 1 6 7 7 8 1 1 1 1 1 1 1 1 1 1 1 1 1 13
14 1 4 3 3 5 1 1 1 1 2 2 2 2 2 1 1 1 1 13
14 1 4 3 3 5 1 1 1 1 1 1 1 1 1 1 1 1 1 13
14 1 4 3 3 5 1 1 1 1 1 1 1 1 1 1 1 1 1 13
14 1 9 10 10 11 1 1 1 1 1 1 1 1 1 1 1 1 1 13
14 1 1 1 1 1 1 1 1 1 1 1 1 1 1 1 1 1 1 13
22 16 16 16 16 16 16 16 16 16 16 16 16 16 16 16 16 16 16 21