2 2 2 2 2 2 2 2 2 2 2 2 2 2 2 2 2 2 2 2
2 25 25 25 25 25 25 25 25 25 25 25 25 25 25 25 25 25 25 2
2 25 25 25 25 25 25 25 25 25 25 25 25 25 25 25 25 25 25 2
2 25 25 1 1 1 1 1 1 1 1 1 1 1 1 1 1 25 25 2
2 25 25 1 1 1 1 1 1 1 1 1 1 1 1 1 1 25 25 2
2 25 25 1 1 1 1 1 1 1 1 1 1 1 1 1 1 25 25 2
2 25 25 1 1 1 1 1 1 1 1 1 1 1 1 1 1 25 25 2
2 25 25 1 1 1 1 1 1 1 1 1 1 1 1 1 1 25 25 2
2 25 25 1 1 1 1 1 1 1 1 1 1 1 1 1 1 25 25 2
2 25 25 25 25 25 25 25 25 25 25 25 25 25 25 25 25 25 25 2
2 25 25 25 25 25 25 25 25 25 25 25 25 25 25 25 25 25 25 2
2 2 2 2 2 2 2 2 2 2 2 2 2 2 2 2 2 2 2 2